Kausi;Joukkue;Kokonaistulot;Ansiotulot;Pääomatulot;Koko_nimi
2019-2020;HIFK;116567;116567;0;Ahonen Rony
2019-2020;HIFK;7398;7398;0;And Terry
2019-2020;HIFK;34523;34523;0;Dyk Sebastian
2019-2020;HIFK;31992;31992;0;Engberg Teemu
2019-2020;HIFK;84821;84673;148;Engren Atte
2019-2020;HIFK;38109;38109;0;Järvinen Joonas
2019-2020;HIFK;29328;25852;3476;Jääskä Juha
2019-2020;HIFK;141944;140102;1842;Kangasniemi Iikka
2019-2020;HIFK;91641;91641;0;Kankaanperä Markus
2019-2020;HIFK;58863;56051;2812;Keränen Juho
2019-2020;HIFK;31574;22348;9226;Keränen Michael
2019-2020;HIFK;106213;105647;566;Kousa Mikko
2019-2020;HIFK;57117;51146;5971;Laakso Aleksi
2019-2020;HIFK;13250;13250;0;Lambert Brad
2019-2020;HIFK;198621;198621;0;Leskinen Ville
2019-2020;HIFK;33908;33908;0;Lundell Anton
2019-2020;HIFK;197492;197492;0;Lyytinen Joonas
2019-2020;HIFK;148172;148172;0;Motin Johan
2019-2020;HIFK;29099;29099;0;Nordgren Niklas
2019-2020;HIFK;106300;106300;0;Nykopp Thomas
2019-2020;HIFK;103675;99905;3770;Paajanen Otto
2019-2020;HIFK;123970;123970;0;Petrell Lennart
2019-2020;HIFK;101196;98539;2657;Saarinen Jesse
2019-2020;HIFK;82885;82885;0;Sallinen Jere
2019-2020;HIFK;62730;59939;2791;Tallberg Teemu
2019-2020;HIFK;21843;21843;0;Teräväinen Eero
2019-2020;HIFK;87018;87018;0;Tuohimaa Frans
2019-2020;HIFK;112218;112218;0;Turunen Teemu
2019-2020;HIFK;103702;103702;0;Tyrväinen Antti
2019-2020;HIFK;36509;36509;0;Ulander Elias
2019-2020;HIFK;86924;79928;6996;Varakas Ville
2019-2020;HIFK;20224;20224;0;Winberg Topias
2019-2020;HIFK;51502;51502;0;Åsten Micke-Max
2019-2020;HPK;137378;137378;0;Cornet Philippe
2019-2020;HPK;74162;74162;0;Eronen Elmeri
2019-2020;HPK;11301;11301;0;Friman Niklas
2019-2020;HPK;44961;44961;0;Ikonen Ossi
2019-2020;HPK;50713;50713;0;Innala Jere
2019-2020;HPK;55650;54954;696;Kanninen Henri
2019-2020;HPK;41567;41491;76;Karjalainen Antti
2019-2020;HPK;50095;50095;0;Karjalainen Miro
2019-2020;HPK;1871;1871;0;Kombe Kristjan
2019-2020;HPK;27622;27622;0;Krivosik Filip
2019-2020;HPK;193501;193501;0;Kunyk Cody
2019-2020;HPK;91438;89867;1571;Laatikainen Arto
2019-2020;HPK;33107;33107;0;Laavainen Roope
2019-2020;HPK;23654;23654;0;Lahtela Mikko
2019-2020;HPK;47545;47545;0;Latvala Otto
2019-2020;HPK;54668;54668;0;Lucenius Niclas
2019-2020;HPK;133670;133670;0;Lukka Santeri
2019-2020;HPK;29775;27335;2440;Monto Joona
2019-2020;HPK;97447;97447;0;Nenonen Markus
2019-2020;HPK;100943;100943;0;Nikkilä Petteri
2019-2020;HPK;27899;27899;0;Nurmikanta Nico
2019-2020;HPK;27891;27891;0;Puustinen Valtteri
2019-2020;HPK;24801;22868;1933;Reijola Rasmus
2019-2020;HPK;27387;27387;0;Ruokonen Miro
2019-2020;HPK;19927;19413;514;Seppälä Erkka
2019-2020;HPK;85800;71770;14030;Tavi Janne
2019-2020;HPK;48527;48527;0;Tikka Tommi
2019-2020;HPK;74151;74151;0;Voutilainen Joona
2019-2020;Ilves;20907;20907;0;Ahopelto Erik
2019-2020;Ilves;38230;37806;424;Antonen Joose
2019-2020;Ilves;27945;27945;0;Dostál Lukás
2019-2020;Ilves;89895;89895;0;Elorinne Aleksi
2019-2020;Ilves;33227;32748;479;Haapanen Topias
2019-2020;Ilves;17728;17728;0;Hatakka Santeri
2019-2020;Ilves;93439;92793;646;Ikonen Jasse
2019-2020;Ilves;44530;44530;0;Ikonen Joona
2019-2020;Ilves;44966;44966;0;Kolppanen Ville
2019-2020;Ilves;106407;106407;0;Laaksonen Oskari
2019-2020;Ilves;85298;83376;1922;Leino Robert
2019-2020;Ilves;69053;69053;0;Lepaus Teemu
2019-2020;Ilves;72802;71397;1405;Maalahti Kalle
2019-2020;Ilves;26620;26620;0;Maccelli Matias
2019-2020;Ilves;29338;25576;3762;Matinpalo Nikolas
2019-2020;Ilves;63065;63065;0;Mieho Panu
2019-2020;Ilves;9796;9750;46;Nalli Miro
2019-2020;Ilves;68419;68391;28;Parikka Jarkko
2019-2020;Ilves;75031;73696;1335;Peltola Niko
2019-2020;Ilves;11456;11456;0;Pukka Mikko
2019-2020;Ilves;16839;16839;0;Päkkilä Eetu
2019-2020;Ilves;107849;107849;0;Rautiainen Teemu
2019-2020;Ilves;133449;133449;0;Ruotsalainen Arttu
2019-2020;Ilves;30284;30284;0;Saarela Antti
2019-2020;Ilves;35545;34580;965;Salmela Tuomas
2019-2020;Ilves;92315;92315;0;Suomi Eemeli
2019-2020;Ilves;35505;35505;0;Thomson Lassi
2019-2020;Ilves;30834;30834;0;Vainionpää Samuli
2019-2020;Jukurit;30070;30070;0;Aho Juhana
2019-2020;Jukurit;17657;17657;0;Galvas Jakub
2019-2020;Jukurit;5984;5970;14;Haarti Jaakko
2019-2020;Jukurit;42235;42107;128;Henritius Teemu
2019-2020;Jukurit;31335;31335;0;Hotakainen Valtteri
2019-2020;Jukurit;7056;7056;0;Huttunen Heikki
2019-2020;Jukurit;18752;18752;0;Hyvärinen Ville
2019-2020;Jukurit;35098;35098;0;Jaatinen Antti
2019-2020;Jukurit;35384;35384;0;Jalonen Jimi
2019-2020;Jukurit;36211;36211;0;Kalliola Joonas
2019-2020;Jukurit;6732;6726;16;Kemppainen Samuel
2019-2020;Jukurit;77602;77602;0;Kokkonen Mikko
2019-2020;Jukurit;36034;36034;0;Kuukka Mikko
2019-2020;Jukurit;42598;42598;0;Leskinen Ville
2019-2020;Jukurit;40517;40517;0;Nikkanen Henri
2019-2020;Jukurit;85807;81240;4567;Partanen Mika
2019-2020;Jukurit;62860;62860;0;Pereskokov Vadim
2019-2020;Jukurit;43334;43334;0;Piipponen Samuli
2019-2020;Jukurit;74367;74367;0;Piitulainen Jesper
2019-2020;Jukurit;21575;21575;0;Puistola Patrik
2019-2020;Jukurit;57494;57494;0;Rajaniemi Sami
2019-2020;Jukurit;17936;17936;0;Rantaeskola Julius
2019-2020;Jukurit;8492;8492;0;Rindell Axel
2019-2020;Jukurit;33657;31242;2415;Ritamäki Janne
2019-2020;Jukurit;65656;65654;2;Roine Miika
2019-2020;Jukurit;15767;15767;0;Sarault Charlie
2019-2020;Jukurit;25359;25208;2151;Tanus Kristian
2019-2020;Jukurit;50307;48125;2182;Vähätalo Julius
2019-2020;Jukurit;22645;22645;0;Weigel Fredric
2019-2020;JYP;34915;34915;0;Allén Roni
2019-2020;JYP;73023;73023;0;Helenius Riku
2019-2020;JYP;59476;59476;0;Honka Anttoni
2019-2020;JYP;144275;109769;34506;Hytönen Juha-Pekka
2019-2020;JYP;44961;44961;0;Ikonen Ossi
2019-2020;JYP;126177;126177;0;Immonen Jarkko
2019-2020;JYP;44449;44449;0;Jokinen Jaakko
2019-2020;JYP;750;750;0;Kakkonen Valtteri
2019-2020;JYP;8092;8092;0;Kalajanniska Oskari
2019-2020;JYP;61902;61902;0;Kalapudas Antti
2019-2020;JYP;103876;97869;6007;Kalteva Mikko
2019-2020;JYP;96148;96148;0;Laurikainen Eetu
2019-2020;JYP;36286;36286;0;Lindroos Alex
2019-2020;JYP;31278;31278;0;Lintuniemi Alex
2019-2020;JYP;144406;143325;1081;Louhivaara Ossi
2019-2020;JYP;148857;144096;4761;Mäenpää Mikko
2019-2020;JYP;100415;100415;0;Nättinen Julius
2019-2020;JYP;29785;29785;0;Ratinen Samuli
2019-2020;JYP;57893;57893;0;Rooba Robert
2019-2020;JYP;25109;25109;0;Rutanen Aleksi
2019-2020;JYP;48446;48446;0;Ruusu Markus
2019-2020;JYP;14591;14591;0;Siikanen Patrik
2019-2020;JYP;77030;77030;0;Siikonen Miska
2019-2020;JYP;18542;18542;0;Stråka Anton
2019-2020;JYP;126405;126405;0;Tuppurainen Jani
2019-2020;JYP;56049;56049;0;Turkulainen Jerry
2019-2020;JYP;96202;96202;0;Vainio Juuso
2019-2020;JYP;9437;9437;0;Viinikainen Olli-Petteri
2019-2020;KalPa;40228;40228;0;Aaltonen Leevi
2019-2020;KalPa;96927;96927;0;Gröndahl Ari
2019-2020;KalPa;25973;25973;0;Huttunen Otto
2019-2020;KalPa;82701;79919;2782;Ikonen Joni
2019-2020;KalPa;73386;72300;1086;Jokinen Tommi
2019-2020;KalPa;86870;83241;3629;Järvinen Matti
2019-2020;KalPa;108911;108911;0;Kantola Kai
2019-2020;KalPa;120986;120986;0;Keränen Janne
2019-2020;KalPa;41824;41824;0;Kilpeläinen Eero
2019-2020;KalPa;28217;28217;0;Klemetti Aleksi
2019-2020;KalPa;28392;28392;0;Knuutinen Henri
2019-2020;KalPa;21811;21811;0;Könönen Juuso
2019-2020;KalPa;51760;51760;0;Lappalainen Lasse
2019-2020;KalPa;20745;20745;0;Nousiainen Kim
2019-2020;KalPa;50198;50198;0;Nuutinen Mikko
2019-2020;KalPa;52550;50402;2148;Perhonen Samu
2019-2020;KalPa;50638;50638;0;Pitkänen Miikka
2019-2020;KalPa;20200;20200;0;Riekkinen Joona
2019-2020;KalPa;111353;102531;8822;Ruuttu Alexander
2019-2020;KalPa;107177;107177;0;Sebok Balazs
2019-2020;KalPa;44920;44920;0;Seppälä Mikael
2019-2020;KalPa;41641;40648;993;Timonen Jussi
2019-2020;KalPa;16859;16647;212;Vartiainen Tuomas
2019-2020;KalPa;39333;38516;817;Virtanen Mikko
2019-2020;KalPa;112006;112006;0;Wilson Ryan
2019-2020;Kookoo;43415;43415;0;Berger Martin
2019-2020;Kookoo;91582;91582;0;Bonsaksen Alexander
2019-2020;Kookoo;38462;38462;0;Caito Matthew
2019-2020;Kookoo;28284;28284;0;Friberg Jere
2019-2020;Kookoo;39857;39857;0;Gallo Vilmos
2019-2020;Kookoo;138720;138720;0;Haataja Juha-Pekka
2019-2020;Kookoo;77962;77962;0;Hakulinen Anrei
2019-2020;Kookoo;43232;43232;0;Halonen Niilo
2019-2020;Kookoo;91007;91007;0;Haukeland Henrik
2019-2020;Kookoo;74460;74460;0;Karlsson Erik
2019-2020;Kookoo;37257;37257;0;Koivisto Kimi
2019-2020;Kookoo;18359;18254;105;Korhonen Olli
2019-2020;Kookoo;71192;53292;17900;Kähkönen Toni
2019-2020;Kookoo;33107;33107;0;Laavainen Roope
2019-2020;Kookoo;56150;53413;2737;Manninen Oskari
2019-2020;Kookoo;47667;47667;0;Mingoia Trevor
2019-2020;Kookoo;8862;8862;0;Oden Joonas
2019-2020;Kookoo;31111;31111;0;Ojantakanen Kasperi
2019-2020;Kookoo;34353;33117;1236;Pelli Arttu
2019-2020;Kookoo;27021;27021;0;Pltatzer Kyle
2019-2020;Kookoo;62041;59423;2618;Rautanen Juho
2019-2020;Kookoo;27980;27980;0;Salmela Santeri
2019-2020;Kookoo;21773;21773;0;Seppälä Peetro
2019-2020;Kookoo;72984;72984;0;Strömberg Kim
2019-2020;Kookoo;30753;30753;0;Suuronen Toni
2019-2020;Kookoo;25255;23771;1484;Valtola Kalle
2019-2020;Kärpät;121673;121673;0;Aaltonen Juhamatti
2019-2020;Kärpät;39835;39835;0;Annunen Justus
2019-2020;Kärpät;46770;46770;0;Anttila Sami
2019-2020;Kärpät;102688;102688;0;Byström Ludwig
2019-2020;Kärpät;23797;23797;0;Hermonen Julius
2019-2020;Kärpät;259399;259399;0;Heshka Shaun
2019-2020;Kärpät;61875;61875;0;Humaloja Miska
2019-2020;Kärpät;22734;22734;0;Huttula Joona
2019-2020;Kärpät;88891;88891;0;Jokinen Jussi
2019-2020;Kärpät;24303;24303;0;Junttila Julius
2019-2020;Kärpät;53376;52864;512;Karvinen Otto
2019-2020;Kärpät;58481;58481;0;Koblizek Radek
2019-2020;Kärpät;38172;38172;0;Koskenkorva Jesse
2019-2020;Kärpät;288689;288689;0;Krejcik Jakub
2019-2020;Kärpät;115473;115473;0;Kristof Michal
2019-2020;Kärpät;196561;196561;0;Kukkonen Lasse
2019-2020;Kärpät;56377;56377;0;Lammikko Juho
2019-2020;Kärpät;74881;74881;0;Lindsten Jasper
2019-2020;Kärpät;26015;26015;0;Metsävainio Tino
2019-2020;Kärpät;87041;87041;0;Niemelä Mikko
2019-2020;Kärpät;11292;11292;0;Niemelä Topi
2019-2020;Kärpät;47620;47620;0;Puljujärvi Jesse
2019-2020;Kärpät;161257;161257;0;Pyörälä Mika
2019-2020;Kärpät;62386;62386;0;Ronkainen Taneli
2019-2020;Kärpät;116770;116770;0;Rybar Patrik
2019-2020;Kärpät;13544;13544;0;Räty Aatu
2019-2020;Kärpät;8256;8256;0;Räty Aku
2019-2020;Kärpät;65563;58471;7092;Sailio Jari
2019-2020;Lukko;101826;101826;0;Danforth Justin
2019-2020;Lukko;86374;86374;0;Elo Eero
2019-2020;Lukko;100813;84325;16488;Heikkinen Ilkka
2019-2020;Lukko;143343;143343;0;Heinola Ville
2019-2020;Lukko;45172;45172;0;Klok Lukas
2019-2020;Lukko;132949;132949;0;Koivisto Toni
2019-2020;Lukko;49836;49836;0;Koivistoinen Eetu
2019-2020;Lukko;26445;26445;0;Kukkonen Miska
2019-2020;Lukko;68495;60616;7879;Laakso Tapio
2019-2020;Lukko;21159;21159;0;Laitinen Vili
2019-2020;Lukko;46503;46503;0;Lehtinen Lassi
2019-2020;Lukko;63945;63945;0;Liedes Heikki
2019-2020;Lukko;24248;24248;0;Nemecek David
2019-2020;Lukko;59770;59770;0;Nyman Linus
2019-2020;Lukko;15751;15681;70;Palojärvi Antti
2019-2020;Lukko;22711;22711;0;Petman Mikko
2019-2020;Lukko;22066;22066;0;Petman Ville
2019-2020;Lukko;295160;29516;0;Pospisil Kristian
2019-2020;Lukko;20839;20839;0;Press Robin
2019-2020;Lukko;26835;26835;0;Repo Sebastian
2019-2020;Lukko;43841;38589;5252;Reunanen Tarmo
2019-2020;Lukko;13686;13686;0;Ruotsi Jesse
2019-2020;Lukko;84178;84178;0;Setänen Oskari
2019-2020;Lukko;59927;59927;0;Sevänen Roni
2019-2020;Lukko;89832;89832;0;Sopanen Vili
2019-2020;Lukko;36516;32082;4434;Tammela Jonne
2019-2020;Lukko;32640;32640;0;Vidgren Aaro
2019-2020;Pelicans;121673;121673;0;Aaltonen Juhamatti
2019-2020;Pelicans;65264;65264;0;Björninen Hannes
2019-2020;Pelicans;18696;18696;0;Ek Aleksi
2019-2020;Pelicans;36034;36034;0;Elimäki Roope
2019-2020;Pelicans;57672;56392;1280;Gymer Frank
2019-2020;Pelicans;4169;4169;0;Haatanen Aleks
2019-2020;Pelicans;3426;3426;0;Hämäläinen Sakke
2019-2020;Pelicans;151207;59653;91554;Jaakola Topi
2019-2020;Pelicans;66519;62963;3556;Jalasvaara Janne
2019-2020;Pelicans;55243;55243;0;Jürgens Casimir
2019-2020;Pelicans;23311;23311;0;Kinnunen Santtu
2019-2020;Pelicans;49568;49568;0;Lahtinen Severi
2019-2020;Pelicans;120541;118388;2153;Mankinen Jesse
2019-2020;Pelicans;14571;14571;0;Merelä Waltteri
2019-2020;Pelicans;89187;88928;259;Mustonen Aleksi
2019-2020;Pelicans;47604;47604;0;Nieminen Otto
2019-2020;Pelicans;22109;22109;0;Pietroniro Matteo
2019-2020;Pelicans;19902;19902;0;Pynnönen Jarkko
2019-2020;Pelicans;27942;27942;0;Saarelainen Miro-Pekka
2019-2020;Pelicans;56904;55178;1726;Tanus Jonatan
2019-2020;Pelicans;25024;25024;0;Tolvanen Atte
2019-2020;Pelicans;103702;103702;0;Tyrväinen Antti
2019-2020;Pelicans;36509;36509;0;Ulander Elias
2019-2020;Pelicans;50176;50176;0;Vartiainen Taavi
2019-2020;Pelicans;55962;55962;0;Ylönen Jesse
2019-2020;SaiPa;36644;36644;0;Autio Erik
2019-2020;SaiPa;41211;41211;0;Grman Mario
2019-2020;SaiPa;30792;30792;0;Iso-Mustajärvi Tomi
2019-2020;SaiPa;38368;38368;0;Kaarlehto Karolus
2019-2020;SaiPa;6274;0;6274;Kiiskinen Tuomas
2019-2020;SaiPa;58177;58177;0;Koho Ville
2019-2020;SaiPa;30565;30530;35;Kojo Markus
2019-2020;SaiPa;46909;46909;0;Kuronen Mikael
2019-2020;SaiPa;103997;103100;897;Löfman Anssi
2019-2020;SaiPa;11016;11016;0;Mäntykivi Matias
2019-2020;SaiPa;47187;47187;0;Nikko Joni
2019-2020;SaiPa;29101;29101;0;Oksanen Emil
2019-2020;SaiPa;26152;26152;0;Piipponen Topi
2019-2020;SaiPa;66498;66498;0;Ramstedt Teemu
2019-2020;SaiPa;28996;28976;20;Riikola Simo-Pekka
2019-2020;SaiPa;51518;49865;1653;Saari Micke
2019-2020;SaiPa;67726;66729;997;Salo Robin
2019-2020;SaiPa;44382;44382;0;Sneck Jere
2019-2020;SaiPa;27648;27648;0;Vainikainen Ville
2019-2020;SaiPa;28068;28068;0;Vainio Veeti
2019-2020;SaiPa;106362;106362;0;Westerholm Niclas
2019-2020;SaiPa;56636;56636;0;Virtanen Santeri
2019-2020;SaiPa;168103;168103;0;Zaborsky Tomas
2019-2020;Sport;29409;29409;0;Ainali Aleksi
2019-2020;Sport;69302;66250;3052;Asplund Turo
2019-2020;Sport;83995;83995;0;DeSousa Christopher
2019-2020;Sport;14262;14262;0;Erholtz Emil
2019-2020;Sport;95587;89810;5777;Erkinjuntti Antti
2019-2020;Sport;29502;29502;0;Geiger Paul
2019-2020;Sport;96827;96827;0;Gröndahl Ari
2019-2020;Sport;3011;3011;0;Haarala Santeri
2019-2020;Sport;38042;38042;0;Hovinen Niko
2019-2020;Sport;91787;91787;0;Järvinen Mika
2019-2020;Sport;61902;61902;0;Kalapudas Antti
2019-2020;Sport;49665;49665;0;Kallela Toni
2019-2020;Sport;16998;16998;0;Kuiri Niko
2019-2020;Sport;13822;13822;0;Lehtimäki Miro
2019-2020;Sport;43416;43416;0;Liuksiala Juho
2019-2020;Sport;54653;54653;0;Nevalainen Niklas
2019-2020;Sport;33791;33791;0;Paukku Jesse
2019-2020;Sport;39838;39838;0;Riska Erik
2019-2020;Sport;41506;41033;473;Riska Filip
2019-2020;Sport;50943;50943;0;Seigo Steven
2019-2020;Sport;52867;52867;0;Steen Stefan
2019-2020;Sport;79792;79789;3;Suoranta Simon
2019-2020;Sport;70170;70170;0;Talaja Roope
2019-2020;Sport;47535;47535;0;Tommila Juho
2019-2020;Sport;41713;41713;0;Tuohilampi Kristian
2019-2020;Sport;31636;31604;32;Westermarck Victor
2019-2020;Sport;29180;29180;0;Wilson Jared
2019-2020;Sport;54630;52798;1832;Viljanen Valtteri
2019-2020;Tappara;75190;75190;0;Bertrand Charles
2019-2020;Tappara;110112;110112;0;Blood Ben
2019-2020;Tappara;34379;34379;0;Garteig Michael
2019-2020;Tappara;59247;56948;2299;Heljanko Christian
2019-2020;Tappara;86972;86972;0;Jasu Juhani
2019-2020;Tappara;88395;88395;0;Karjalainen Jere
2019-2020;Tappara;85803;85803;0;Kemiläinen Valtteri
2019-2020;Tappara;205189;205189;0;Kuusela Kristian
2019-2020;Tappara;31043;31043;0;Lehtonen Matias
2019-2020;Tappara;40833;40833;0;Levtchi Anton
2019-2020;Tappara;97441;97441;0;Malinen Jarkko
2019-2020;Tappara;48656;48656;0;Moilanen Sami
2019-2020;Tappara;114042;114042;0;Morley Tyler
2019-2020;Tappara;95174;74630;20544;Mäntylä Tuukka
2019-2020;Tappara;144754;144444;310;Ojamäki Niko
2019-2020;Tappara;17862;17862;0;Ollikainen Anton
2019-2020;Tappara;21575;21575;0;Puistola Patrik
2019-2020;Tappara;57271;57271;0;Rauhala Otto
2019-2020;Tappara;17405;17405;0;Rouhiainen Jere
2019-2020;Tappara;76592;76353;239;Suhonen Teemu
2019-2020;Tappara;42572;42572;0;Utunen Toni
2019-2020;Tappara;96815;96815;0;Vauhkonen Olavi
2019-2020;Tappara;96815;59773;632;Virta Patrik
2019-2020;Tappara;58808;58808;0;Vittasmäki Veli-Matti
2019-2020;Tappara;79205;79205;0;Ytterell Alexander
2019-2020;TPS;20141;20141;0;Anttalainen Aleksi
2019-2020;TPS;142081;142081;0;Budish Zach
2019-2020;TPS;136420;99450;36970;Filppula Ilari
2019-2020;TPS;59895;58998;897;Forsttröm Jani
2019-2020;TPS;32766;32766;0;Karvonen Elias
2019-2020;TPS;9420;9420;0;Janatuinen Joel
2019-2020;TPS;32986;32986;0;Kaskinen Olli
2019-2020;TPS;270855;244008;26847;Korpikoski Lauri
2019-2020;TPS;34184;34022;162;Kuru Hannu
2019-2020;TPS;133670;133670;0;Lukka Santeri
2019-2020;TPS;54568;54073;495;Pajuniemi Lauri
2019-2020;TPS;182035;182035;0;Piskula Joe
2019-2020;TPS;8898;8898;0;Pärssinen Juuso
2019-2020;Ässät;97123;97123;0;Aittokallio Sami
2019-2020;Ässät;43975;43975;0;Appelgren Niklas
2019-2020;Ässät;33227;32748;479;Haapanen Topias
2019-2020;Ässät;10997;10997;0;Henttonen Toni
2019-2020;Ässät;28217;19694;8523;Juhola Jouka
2019-2020;Ässät;26440;26440;0;Killinen Lenni
2019-2020;Ässät;24823;24823;0;Kivelä Niko
2019-2020;Ässät;32718;32718;0;Kivenmäki Otto
2019-2020;Ässät;28328;27565;673;Kulmala Lauri
2019-2020;Ässät;37645;37645;0;Lähteenmäki Sami
2019-2020;Ässät;87634;79677;7957;Marttinen Jyri
2019-2020;Ässät;5225;5225;0;Matinmikko Aleksi
2019-2020;Ässät;13246;13246;0;Mäkinen Atte
2019-2020;Ässät;15419;15419;0;Mäkinen Miro
2019-2020;Ässät;24523;24523;0;Peltomäki Niklas
2019-2020;Ässät;10306;10306;0;Pihlajamäki Valtteri
2019-2020;Ässät;68329;65687;2642;Rekonen Aleksi
2019-2020;Ässät;73793;73793;0;Salmela Saku
2019-2020;Ässät;56587;52277;4310;Salmio Mikko
2019-2020;Ässät;11829;11829;0;Sammalisto Jerry
2019-2020;Ässät;36183;36183;0;Spink Tylor
2019-2020;Ässät;36183;36183;0;Spink Tyson
2019-2020;Ässät;22645;22645;0;Stenqvist Jakob
2019-2020;Ässät;141244;140734;510;Taimi Tommi
2019-2020;Ässät;31403;31403;0;Tarasov Daniil
2019-2020;Ässät;98604;98604;0;Tiivola Peter
2019-2020;Ässät;51504;48756;2748;Vainio Olli
2019-2020;Ässät;26332;26332;0;Varttinen Aleksi
2019-2020;Ässät;42569;42569;0;Vuorisalo Teemu
2019-2020;Ässät;22567;22567;0;Åkerström Simon
2018-2019;HIFK;4370;4370;0;And Terry
2018-2019;HIFK;22059;22059;0;Engberg Teemu
2018-2019;HIFK;172261;79862;92399;Engren Atte
2018-2019;HIFK;165359;165359;0;Eronen Teemu
2018-2019;HIFK;183457;183457;0;Finley Joe
2018-2019;HIFK;34093;34093;0;Jääskä Juha
2018-2019;HIFK;121852;120767;1085;Kangasniemi Iikka
2018-2019;HIFK;98558;98558;0;Kankaanperä Markus
2018-2019;HIFK;58307;56308;1999;Keränen Juho
2018-2019;HIFK;44780;44780;0;Koivisto Henrik
2018-2019;HIFK;18736;18736;0;Kulmala Lauri
2018-2019;HIFK;0;0;0;Lessio Lucas
2018-2019;HIFK;36222;31050;5172;Laakso Aleksi
2018-2019;HIFK;11402;11402;0;Lundell Anton
2018-2019;HIFK;56815;56815;0;Lyytinen Joonas
2018-2019;HIFK;175373;175373;0;Motin Johan
2018-2019;HIFK;22175;22175;0;Nordgren Niklas
2018-2019;HIFK;86324;86324;0;Nykopp Thomas
2018-2019;HIFK;155067;155067;0;O'Connor Ryan
2018-2019;HIFK;123541;123541;0;Petrell Lennart
2018-2019;HIFK;31228;31228;0;Pitkänen Ilmari
2018-2019;HIFK;121550;121550;0;Quincey Kyle
2018-2019;HIFK;146680;146680;0;Rask Joonas
2018-2019;HIFK;41748;41747;1;Ruusu Markus
2018-2019;HIFK;75707;71664;4043;Santala Tommi
2018-2019;HIFK;56299;55063;1236;Tallberg Teemu
2018-2019;HIFK;240473;240473;0;Thorell Erik
2018-2019;HIFK;110253;110253;0;Tyrväinen Juhani
2018-2019;HIFK;29027;29027;0;Ulander Elias
2018-2019;HIFK;111434;104464;6970;Varakas Ville
2018-2019;HIFK;54882;54882;0;Åsten Micke-Max
2018-2019;HPK;28155;28155;0;Almari Niclas
2018-2019;HPK;48622;48622;0;Cornet Philippe
2018-2019;HPK;61481;60278;1203;Friman Niklas
2018-2019;HPK;21890;21890;0;Innala Jere
2018-2019;HPK;26360;26360;0;Kainulainen Harri
2018-2019;HPK;29242;29160;82;Karjalainen Antti
2018-2019;HPK;31856;31856;0;Karjalainen Miro
2018-2019;HPK;17907;17907;0;Krivosik Filip
2018-2019;HPK;73324;73061;263;Laatikainen Arto
2018-2019;HPK;25574;25574;0;Laavainen Roope
2018-2019;HPK;132081;132081;0;Lahti Janne
2018-2019;HPK;57472;57472;0;Larmi Emil
2018-2019;HPK;68512;68512;0;Leino Robert
2018-2019;HPK;82192;82192;0;Lindgren Jesper
2018-2019;HPK;23877;23877;0;Lucenius Niclas
2018-2019;HPK;73478;73478;0;Nenonen Markus
2018-2019;HPK;46966;46966;0;Niemeläinen Markus
2018-2019;HPK;72512;72512;0;Nikkilä Petteri
2018-2019;HPK;80002;80002;0;Paajanen Otto
2018-2019;HPK;8681;8681;0;Puustinen Valtteri
2018-2019;HPK;23842;21470;2372;Riska Filip
2018-2019;HPK;27579;27579;0;Ruokonen Miro
2018-2019;HPK;8793;8339;454;Seppälä Erkka
2018-2019;HPK;50452;50452;0;Turunen Teemu
2018-2019;HPK;69102;68599;503;Tuulola Eetu
2018-2019;Ilves;3964;3964;0;Ahopelto Erik
2018-2019;Ilves;84376;84376;0;Ahtola Jerry
2018-2019;Ilves;36469;36222;247;Antonen Joose
2018-2019;Ilves;75825;75825;0;Flood Mark
2018-2019;Ilves;35999;35999;0;Generous Matt
2018-2019;Ilves;17058;17056;2;Haapanen Topias
2018-2019;Ilves;66499;66499;0;Halmo Mike
2018-2019;Ilves;100115;100115;0;Helenius Riku
2018-2019;Ilves;19048;19048;0;Ikonen Joona
2018-2019;Ilves;39058;39058;0;Laaksonen Oskari
2018-2019;Ilves;44059;44059;0;Lehtonen Antti
2018-2019;Ilves;83894;83894;0;Leimu Juha
2018-2019;Ilves;41168;41168;0;Lepaus Teemu
2018-2019;Ilves;29001;29001;0;Liuksiala Juho
2018-2019;Ilves;7055;7055;0;Matinpalo Nikolas
2018-2019;Ilves;45944;45944;0;Mieho Panu
2018-2019;Ilves;69218;69218;0;Parikka Jarkko
2018-2019;Ilves;77618;77618;0;Peltola Niko
2018-2019;Ilves;100367;100367;0;Rautiainen Teemu
2018-2019;Ilves;32974;32972;2;Ruotsalainen Arttu
2018-2019;Ilves;22169;21126;1043;Salmela Tuomas
2018-2019;Ilves;62185;58451;3734;Savilahti Eero
2018-2019;Ilves;73633;73633;0;Suomi Eemeli
2018-2019;Ilves;48966;48966;0;Tamminen Juhani
2018-2019;Ilves;48057;47942;115;Vainio Olli
2018-2019;Ilves;9442;9442;0;Vainionpää Samuli
2018-2019;Ilves;26545;26545;0;Valtonen Julius
2018-2019;Jukurit;23101;23101;0;Aho Juhana
2018-2019;Jukurit;64839;63060;1779;Asplund Turo
2018-2019;Jukurit;61936;55243;6693;Flinck Markku
2018-2019;Jukurit;28200;28198;2;Henritius Teemu
2018-2019;Jukurit;36504;36504;0;Hietanen Valtteri
2018-2019;Jukurit;30930;30930;0;Hotakainen Valtteri
2018-2019;Jukurit;22587;22585;2;Hyvärinen Ville
2018-2019;Jukurit;34129;34129;0;Jaatinen Antti
2018-2019;Jukurit;16455;16455;0;Jalonen Jimi
2018-2019;Jukurit;26475;26473;2;Kalliola Joonas
2018-2019;Jukurit;25742;25742;0;Kokkonen Mikko
2018-2019;Jukurit;10252;10252;0;Koponen Marlo
2018-2019;Jukurit;40180;40180;0;Leskinen Ville
2018-2019;Jukurit;50624;24695;25929;Lähde Nestori
2018-2019;Jukurit;86577;83038;3539;Partanen Mika
2018-2019;Jukurit;16831;16831;0;Pereskokov Vadim
2018-2019;Jukurit;34389;34389;0;Piipponen Samuli
2018-2019;Jukurit;79228;79228;0;Piitulainen Jesper
2018-2019;Jukurit;52861;52861;0;Rajaniemi Sami
2018-2019;Jukurit;34827;32254;2573;Ritamäki Janne
2018-2019;Jukurit;55502;55501;1;Roine Miika
2018-2019;Jukurit;77604;76500;1104;Salonen Aleksi
2018-2019;Jukurit;55491;55491;0;Suhonen Teemu
2018-2019;Jukurit;89777;76498;13279;Tavi Janne
2018-2019;Jukurit;29494;27299;2195;Vähätalo Julius
2018-2019;JYP;20391;20391;0;Allén Roni
2018-2019;JYP;0;0;0;Eklund Oscar
2018-2019;JYP;34292;34292;0;Honka Anttoni
2018-2019;JYP;99543;93610;5933;Hytönen Juha-Pekka
2018-2019;JYP;33035;33035;0;Ikonen Ossi
2018-2019;JYP;131049;131049;0;Immonen Jarkko
2018-2019;JYP;40423;40423;0;Jokinen Jaakko
2018-2019;JYP;93850;93096;754;Kalteva Mikko
2018-2019;JYP;66755;66755;0;Kolehmainen Janne
2018-2019;JYP;79274;79274;0;Kuukka Mikko
2018-2019;JYP;33957;33957;0;Lahti Miika
2018-2019;JYP;94325;94325;0;Laurikainen Eetu
2018-2019;JYP;27777;27641;136;Lindroos Alex
2018-2019;JYP;178648;178345;303;Louhivaara Ossi
2018-2019;JYP;137520;132846;4674;Mäenpää Mikko
2018-2019;JYP;80727;80727;0;Newton Jake
2018-2019;JYP;28375;28375;0;Nättinen Julius
2018-2019;JYP;133949;133949;0;Perrin Éric
2018-2019;JYP;12880;12880;0;Ratinen Samuli
2018-2019;JYP;34451;34451;0;Rooba Robert
2018-2019;JYP;30036;30036;0;Saari Micke
2018-2019;JYP;17724;17724;0;Stråka Anton
2018-2019;JYP;128661;83358;45303;Tuokkola Pekka
2018-2019;JYP;136552;136552;0;Tuppurainen Jani
2018-2019;JYP;44940;44436;504;Turkulainen Jerry
2018-2019;JYP;87992;87991;1;Vainio Juuso
2018-2019;JYP;53152;53152;0;Voutilainen Joona
2018-2019;JYP;113481;113481;0;Yonkman Nolan
2018-2019;KalPa;81054;81054;0;Godla Denis
2018-2019;KalPa;115046;115046;0;Gröndahl Ari
2018-2019;KalPa;38346;38346;0;Gymer Frank
2018-2019;KalPa;51503;51503;0;Hovinen Niko
2018-2019;KalPa;25296;24399;897;Hyvärinen Toni
2018-2019;KalPa;6684;6601;83;Iilahti Jonathan
2018-2019;KalPa;47843;47721;122;Ikonen Joni
2018-2019;KalPa;73872;73872;0;Jokinen Tommi
2018-2019;KalPa;103057;103057;0;Kantola Kai
2018-2019;KalPa;21070;21070;0;Klemetti Aleksi
2018-2019;KalPa;21438;21438;0;Knuutinen Henri
2018-2019;KalPa;11957;11957;0;Könönen Juuso
2018-2019;KalPa;56942;56942;0;Lappalainen Lasse
2018-2019;KalPa;44713;44713;0;Leskinen Otto
2018-2019;KalPa;38471;38471;0;Luostarinen Eetu
2018-2019;KalPa;3701;3701;0;Metsävainio Elmeri
2018-2019;KalPa;36606;36606;0;Mäkinen Konsta
2018-2019;KalPa;39833;39833;0;Nuutinen Mikko
2018-2019;KalPa;34139;34139;0;Parikka Valtteri
2018-2019;KalPa;22479;22479;0;Piipponen Topi
2018-2019;KalPa;37541;33548;3993;Pikkarainen Ilkka
2018-2019;KalPa;9246;9246;0;Riekkinen Joona
2018-2019;KalPa;89048;83353;5695;Rissanen Jaakko
2018-2019;KalPa;74835;74093;742;Ruuttu Alexander
2018-2019;KalPa;101328;101328;0;Sebök Balázs
2018-2019;KalPa;38626;38307;319;Seppälä Mikael
2018-2019;KalPa;53741;49946;3795;Taipalus Lauri
2018-2019;KalPa;74488;74488;0;Texier Alexandre
2018-2019;KalPa;46089;39086;7003;Vainiola Ville-Vesa
2018-2019;KalPa;85887;85887;0;Wilson Ryan
2018-2019;Kookoo;30668;30668;0;Berger Martin
2018-2019;Kookoo;47944;47944;0;Bonsaksen Alexander
2018-2019;Kookoo;74976;74976;0;Carson Brett
2018-2019;Kookoo;131455;131455;0;Haataja Juha-Pekka
2018-2019;Kookoo;69857;68352;1505;Hakulinen Anrei
2018-2019;Kookoo;105597;105597;0;Järvenpää Juha
2018-2019;Kookoo;53045;53045;0;Kanninen Henri
2018-2019;Kookoo;34725;34725;0;Karlsson Erik
2018-2019;Kookoo;37196;37196;0;Keskitalo Miro
2018-2019;Kookoo;33458;25528;7930;Koivisto Kimi
2018-2019;Kookoo;14136;13518;618;Korhonen Olli
2018-2019;Kookoo;93996;82302;11694;Kähkönen Toni
2018-2019;Kookoo;43536;40214;3322;Leivo Tomi
2018-2019;Kookoo;44134;44134;0;Mutanen Sami
2018-2019;Kookoo;1131;1131;0;Oden Joonas
2018-2019;Kookoo;14197;14197;0;Ojantakanen Kasperi
2018-2019;Kookoo;30956;30956;0;Pelli Arttu
2018-2019;Kookoo;48120;48120;0;Perhonen Samu
2018-2019;Kookoo;35594;35594;0;Pitkänen Miikka
2018-2019;Kookoo;18028;18028;0;Salmela Santeri
2018-2019;Kookoo;70 51;7051;0;Salminen Oskari
2018-2019;Kookoo;6770;6770;0;Seppälä Peetro
2018-2019;Kookoo;34950;34950;0;Strömberg Kim
2018-2019;Kookoo;64728;64728;0;Strömwall Malte
2018-2019;Kookoo;29175;29175;0;Suuronen Toni
2018-2019;Kookoo;21337;21337;0;Tamminen Sami
2018-2019;Kookoo;17849;16907;942;Valtola Kalle
2018-2019;Kookoo;37372;37372;0;Virtanen Mikko
2018-2019;Kookoo;50069;50069;0;Wittchow Ed
2018-2019;Kärpät;40316;40306;10;Anttila Sami
2018-2019;Kärpät;178660;178660;0;Hakanpää Jani
2018-2019;Kärpät;39623;39623;0;Heponiemi Aleksi
2018-2019;Kärpät;218384;218384;0;Heshka Shaun
2018-2019;Kärpät;58885;58885;0;Humaloja Miska
2018-2019;Kärpät;182016;172922;9094;Ikonen Jasse
2018-2019;Kärpät;15219;0;15219;Jokinen Jussi
2018-2019;Kärpät;65568;65568;0;Junnila Jyri
2018-2019;Kärpät;58486;56869;1617;Karvinen Otto
2018-2019;Kärpät;111280;111280;0;Kivihalme Teemu
2018-2019;Kärpät;34209;34209;0;Koblizek Radek
2018-2019;Kärpät;32177;32177;0;Kristof Michal
2018-2019;Kärpät;217566;217566;0;Kukkonen Lasse
2018-2019;Kärpät;125535;125535;0;Kupari Rasmus
2018-2019;Kärpät;154512;154512;0;Lasu Nicklas
2018-2019;Kärpät;130358;130358;0;Leskinen Ville
2018-2019;Kärpät;63771;63771;0;Lindsten Jasper
2018-2019;Kärpät;7805;7805;0;Metsävainio Tino
2018-2019;Kärpät;43499;43499;0;Mäkelä Aleksi
2018-2019;Kärpät;94031;94031;0;Niemelä Mikko
2018-2019;Kärpät;77694;77694;0;Ohtamaa Atte
2018-2019;Kärpät;6093;0;6093;Osala Oskar
2018-2019;Kärpät;88731;88731;0;Pyörälä Mika
2018-2019;Kärpät;46271;46271;0;Ronkainen Taneli
2018-2019;Kärpät;157435;157435;0;Rynnäs Jussi
2018-2019;Kärpät;61042;56608;4434;Sailio Jari
2018-2019;Kärpät;61595;61595;0;Vehviläinen Veini
2018-2019;Pelicans;174928;174928;0;Aaltonen Juhamatti
2018-2019;Pelicans;49304;49304;0;Björninen Hannes
2018-2019;Pelicans;33159;33159;0;Elimäki Roope
2018-2019;Pelicans;42008;42008;0;Ganahl Manuel
2018-2019;Pelicans;36104;36104;0;Jürgens Casimir
2018-2019;Pelicans;52215;52215;0;Kaski Oliwer
2018-2019;Pelicans;11408;11408;0;Kinnunen Santtu
2018-2019;Pelicans;13167;13167;0;Kivelä Niko
2018-2019;Pelicans;144004;144004;0;Kousa Mikko
2018-2019;Pelicans;20656;20656;0;Lahtinen Severi
2018-2019;Pelicans;54230;54230;0;Laine Mikko
2018-2019;Pelicans;96322;96322;0;Mankinen Jesse
2018-2019;Pelicans;79610;79610;0;Mustonen Aleksi
2018-2019;Pelicans;27503;27503;0;Nilsson Henrik
2018-2019;Pelicans;62601;55596;7005;Olkinuora Juho
2018-2019;Pelicans;3954;3954;0;Pynnönen Jarkko
2018-2019;Pelicans;20935;20935;0;Rowley Jordan
2018-2019;Pelicans;53177;53177;0;Saarinen Jesse
2018-2019;Pelicans;21381;21381;0;Salo Niklas
2018-2019;Pelicans;69329;69321;8;Siikonen Miska
2018-2019;Pelicans;28175;28175;0;Skarek Jakub
2018-2019;Pelicans;67782;67782;0;Teppo Miihkali
2018-2019;Pelicans;23980;23980;0;Toivola Artturi
2018-2019;Pelicans;89691;89691;0;Tyrväinen Antti
2018-2019;Pelicans;41347;41347;0;Vartiainen Taavi
2018-2019;Pelicans;23237;23237;0;Ylönen Jesse
2018-2019;Pelicans;60638;60638;0;Zohorna Hynek
2018-2019;SaiPa;13115;13115;0;Autio Erik
2018-2019;SaiPa;0;0;0;Denisov Vladimir
2018-2019;SaiPa;66864;66864;0;Goodwin David
2018-2019;SaiPa;18746;18746;0;Iso-Mustajärvi Tomi
2018-2019;SaiPa;55193;52284;2909;Kaksonen Elmeri
2018-2019;SaiPa;66765;66765;0;Koho Ville
2018-2019;SaiPa;23707;23707;0;Kojo Markus
2018-2019;SaiPa;114054;114054;0;Kunyk Cody
2018-2019;SaiPa;5658;5658;0;Kuronen Mikael
2018-2019;SaiPa;19618;19618;0;Lehtinen Oskari
2018-2019;SaiPa;98968;98327;641;Löfman Anssi
2018-2019;SaiPa;55790;55790;0;Maalahti Kalle
2018-2019;SaiPa;11453;11453;0;Maia Bastien
2018-2019;SaiPa;37621;37621;0;Morley Tyler
2018-2019;SaiPa;47704;47704;0;Nikko Joni
2018-2019;SaiPa;50473;50472;1;Nättinen Topi
2018-2019;SaiPa;61313;61241;72;Oksanen Ahti
2018-2019;SaiPa;12411;12411;0;Oksanen Emil
2018-2019;SaiPa;66310;65433;877;Salo Robin
2018-2019;SaiPa;37388;37388;0;Sneck Jere
2018-2019;SaiPa;59933;54748;5185;Tanus Jonatan
2018-2019;SaiPa;4475;4475;0;Torikka Kasperi
2018-2019;SaiPa;80151;80151;0;Tuohimaa Frans
2018-2019;SaiPa;16042;16042;0;Vainikainen Ville
2018-2019;SaiPa;96370;96370;0;Westerholm Niclas
2018-2019;Sport;31804;31804;0;Ainali Aleksi
2018-2019;Sport;67100;67100;0;Aittokallio Sami
2018-2019;Sport;23149;23149;0;Claireaux Valentin
2018-2019;Sport;2942;2377;565;Haarala Santeri
2018-2019;Sport;112656;112656;0;Järvinen Mika
2018-2019;Sport;67194;67194;0;Kalapudas Antti
2018-2019;Sport;40322;40322;0;Kallela Toni
2018-2019;Sport;44368;44368;0;Kiviranta Joel
2018-2019;Sport;37425;37425;0;Körkkö Tomi
2018-2019;Sport;10315;10315;0;Lehtimäki Miro
2018-2019;Sport;47106;47106;0;Manninen Oskari
2018-2019;Sport;49102;49102;0;Nevalainen Niklas
2018-2019;Sport;51428;49517;1911;Niemi Jyri
2018-2019;Sport;25821;25821;0;Paukku Jesse
2018-2019;Sport;0;0;0;Rapuzzi William
2018-2019;Sport;45997;45997;0;Riska Erik
2018-2019;Sport;0;0;0;Robak Colby
2018-2019;Sport;25440;25440;0;Saukko Ville
2018-2019;Sport;16521;16521;0;Sund Tony
2018-2019;Sport;0;0;0;Sutter Brody
2018-2019;Sport;52019;52019;0;Talaja Roope
2018-2019;Sport;12700;12700;0;Tikka Tommi
2018-2019;Sport;13943;13943;0;Vainonen Mikko
2018-2019;Sport;83314;83314;0;Vauhkonen Olavi
2018-2019;Sport;20376;20348;28;Westermarck Victor
2018-2019;Sport;51656;50485;1171;Viljanen Valtteri
2018-2019;Tappara;64484;64484;0;Blood Ben
2018-2019;Tappara;47688;47688;0;Bäckström Niklas
2018-2019;Tappara;90435;90198;237;Elorinne Aleksi
2018-2019;Tappara;30876;27038;3838;Erkinjuntti Antti
2018-2019;Tappara;58998;58998;0;Heljanko Christian
2018-2019;Tappara;76937;74850;2087;Jasu Juhani
2018-2019;Tappara;91385;89911;1474;Järvinen Jan-Mikael
2018-2019;Tappara;17665;17665;0;Järvinen Joonas
2018-2019;Tappara;50737;46544;4193;Järvinen Matti
2018-2019;Tappara;102399;102399;0;Karjalainen Jere
2018-2019;Tappara;102290;102290;0;Kemiläinen Valtteri
2018-2019;Tappara;222734;222734;0;Kuusela Kristian
2018-2019;Tappara;16431;16431;0;Lehtonen Matias
2018-2019;Tappara;32090;32090;0;Levtchi Anton
2018-2019;Tappara;36592;36592;0;Luoto Joona
2018-2019;Tappara;111530;109533;1997;Malinen Jarkko
2018-2019;Tappara;24175;24175;0;Moilanen Sami
2018-2019;Tappara;46578;46578;0;Mäntylä Tuukka
2018-2019;Tappara;122890;121113;1777;Ojamäki Niko
2018-2019;Tappara;868;868;0;Ollikainen Anton
2018-2019;Tappara;112638;112638;0;Rantakari Otso
2018-2019;Tappara;53382;53382;0;Rauhala Otto
2018-2019;Tappara;42369;42369;0;Rautanen Juho
2018-2019;Tappara;16454;16454;0;Utunen Toni
2018-2019;Tappara;54836;54836;0;Vittasmäki Veli-Matti
2018-2019;Tappara;127472;127472;0;Zaborsky Tomas
2018-2019;TPS;4078;4078;0;Anttila Eetu
2018-2019;TPS;61831;61831;0;Bjorkstrand Patrick
2018-2019;TPS;120780;120780;0;Budish Zach
2018-2019;TPS;90591;90591;0;Ekeståhl Jonsson Lucas
2018-2019;TPS;72768;72768;0;Eronen Elmeri
2018-2019;TPS;184032;97389;86643;Filppula Ilari
2018-2019;TPS;60042;57833;2209;Forsström Jani
2018-2019;TPS;0;0;0;Haukeland Henrik
2018-2019;TPS;119028;107236;11792;Heikkinen Ilkka
2018-2019;TPS;15777;15777;0;Isiguzo Bernard
2018-2019;TPS;12939;12939;0;Kakko Kaapo
2018-2019;TPS;34454;34454;0;Karvonen Elias
2018-2019;TPS;17998;17998;0;Kaskinen Olli
2018-2019;TPS;28950;28800;150;Kuru Hannu
2018-2019;TPS;116547;116547;0;Lukka Santeri
2018-2019;TPS;26530;26530;0;Nieminen Otto
2018-2019;TPS;38997;38997;0;Nurmi Markus
2018-2019;TPS;20791;20791;0;Pajuniemi Lauri
2018-2019;TPS;20045;20045;0;Palmu Petrus
2018-2019;TPS;88065;88065;0;Palve Oula
2018-2019;TPS;0;0;0;Piskula Joe
2018-2019;TPS;40985;40985;0;Siiki Oskari
2018-2019;TPS;70788;70787;1;Suoranta Simon
2018-2019;TPS;41272;41272;0;Tirronen Rasmus
2018-2019;TPS;84105;84105;0;Virtanen Jonne
2018-2019;TPS;35118;35118;0;Väyrynen Teemu
2018-2019;Ässät;36933;36932;1;Appelgren Niklas
2018-2019;Ässät;95298;95298;0;Bernard Andreas
2018-2019;Ässät;18814;18814;0;Huhtanen Tuomas
2018-2019;Ässät;12785;12785;0;Juhola Jouka
2018-2019;Ässät;27621;27621;0;Juusela Aki
2018-2019;Ässät;15109;15109;0;Killinen Lenni
2018-2019;Ässät;11010;11010;0;Kivenmäki Otto
2018-2019;Ässät;43452;43413;39;Kiviaho Henri
2018-2019;Ässät;4793;4793;0;Kotkaniemi Kasperi
2018-2019;Ässät;95674;95674;0;Kärki Jarno
2018-2019;Ässät;46486;46486;0;Lähteenmäki Sami
2018-2019;Ässät;57513;57513;0;Makkonen Jussi
2018-2019;Ässät;166226;157862;8364;Marttinen Jyri
2018-2019;Ässät;77618;77618;0;Peltola Niko
2018-2019;Ässät;14729;14729;0;Peltomäki Niklas
2018-2019;Ässät;64898;63126;1772;Rekonen Aleksi
2018-2019;Ässät;31839;31839;0;Saha Mikael
2018-2019;Ässät;56389;56389;0;Salmela Saku
2018-2019;Ässät;146703;146703;0;Salminen Sakari
2018-2019;Ässät;60678;54263;6415;Salmio Mikko
2018-2019;Ässät;4174;4174;0;Sammalisto Jerry
2018-2019;Ässät;60877;60877;0;Seppälä Jere
2018-2019;Ässät;31243;31243;0;Sillanpää Severi
2018-2019;Ässät;116548;115042;1506;Taimi Tommi
2018-2019;Ässät;94665;94665;0;Tiivola Peter
2018-2019;Ässät;52716;52716;0;Tommila Juho
2018-2019;Ässät;36028;36028;0;Tuohilampi Kristian
2018-2019;Ässät;21017;21016;1;Varttinen Aleksi
2018-2019;Ässät;27318;27318;0;Varttinen Matias
